111111111111111111111111111
111111111111111111111111111
111222221111111111111111111
111222221111111111111111111
111222221111111111111111111
111222221111111111111111111
111222221111111111111111111
111111111111112222111111111
111111111111112222111111111
111111111111112222111111111
111111111111111111111111111
111111111111111111111111111
111111111111111111111111111
111111111111111111111111111
111122222111111111111111111
111122222122111111111111111
111122222122111111111111111
111111111111111111111111111
111111111111111111111111111
111111111111111111111111111
111111111111111111111111111