xxxx11xxxx
xxxx11xxxx
xxx1111xxx
xxx1111xxx
xx111111xx
xx111111xx
x11111111x
x11111111x
1111111111
1111111111